%%%%%%%%%%%%
%P......%%%%
%........%%%
%.........%%
%..........%
%.........%%
%........%%%
%.......%%%%
%....%%%%%%%
%....%%%%%%%
%....%%%%%%%
%....%%%%%%%
%....%%%%%%%
%....%%%%%%%
%%%%%%%%%%%%
